.#..@....##
.#.....####
.###.######
......#####
..##.#.####
.##..###..#
##........#
#.....#..##
###..###..#
##.....?###
###########
