.#..@....##
.#.....####
.###.######
......#####
..#*.#.####
.##..###..#
##....!...#
#.....#..##
###..###..#
##.....?###
###########
