.#..@....##
.#.....##
.###.###
......##
..##.#.####
.##..###..#
##........#
#.....#..#
###..###..#
..#..#....#
.##.##.#.##
