####################
#!!!...............#
#@...!.............#
################!.!#
#..................#
#.!.!###############
#..................#
################!!.#
#..................#
#!!!!.##############
#..................#
################.!.#
#..................#
#.!.!###############
#..................#
################!.!#
#..................#
#.########!#########
#.................?#
####################