#####*##########*###
#..................#
#@.................#
##*##.##########..##
#..................#
#....###########*###
#..................#
#****###########...#
#..................#
#....###############
#..................#
###**###########...#
#..................#
#....###############
#..................#
######*#########...#
#..................#
#.####.#############
#.................?#
####################
