####*####*#####*####
#!!!...............#
#@...!.............#
####*###########!.!#
#..................#
#.!.!#######*#######
#..................#
################!!.#
#..................#
#!!!!.#########*####
#..................#
##*#####*#######.!.#
#..................#
#.!.!########*######
#..................#
#####*##########!.!#
#..................#
#.###*####!#########
#.................?#
####################