#*##*##*##*##*##*#*#
#!!!...............#
#@...!.............#
################!.!#
#..................#
#.!.!#*###*####*##*#
#..................#
##*#########*###!!.#
#..................#
#!!!!.######*#######
#..................#
##*##*##########.!.#
#..................#
#.!.!###*######*####
#..................#
################!.!#
#..................#
#.########!#########
#.................?#
####################